Appetizers: Photo by Brooke Larke on Unsplash
All-Dressed Kale Chips: Photo from Baked Kale Chips Recipe on A Spicy Perspective
Cindy’s Artichoke Dip A: Photo by Nataliya Melnychuk on Unsplash
Cindy's Artichoke Dip B: Photo from Quick and Easy Artichoke Drip on Simply Recipes
Hummus & Pita Chips: Photo by Kyle Brinker on Unsplash
Oven-Baked Camembert: Photo from Pxhere
Pico de Gallo: Photo by Colin McMurry from Unsplash
Spanakopita: Photo from Best-Ever Spanakopita on Delish
Spin’ Dip: Photo from The Best Spinach Artichoke Dip We Ever Had... on Unsplash

Breakfast: Photo by Brooke Larke on Unsplash
Chia Coconut Pudding: Photo by Milada Vigerova on Unsplash
Nonna Pina’s Basic Crepes: Photo by Jean Gerber on Unsplash
Oma & Faye’s German Pancakes: Photo from Crepes with Strawberries and Muscat-Yogurt Sauce from Food & Wine

Beef: Photo by Ján Jakub Naništa from Unsplash
Beef Rouladen: Photo from German Beef Rouladen on Seasons & Suppers
Pan-Seared Steak: Photo from Pan Seared Steak on Unsplash
Pot-Roast in Foil: Photo from Beef Roast in Foil on Onion Rings and Things
Roast Beef Rib with Potatoes: Photo from Braised Beef with Root Vegetables and Red Wine on Oceanstone
Romanian Goulash with Risotto A: Photo from Preserving Tomatoes on Homestead and Chill
Romanian Goulash with Risotto B: Photo from Authentic Hungarian Goulash on Yellow Bliss Road
Romanian Mititei: Photo from Foodcrafing in Romania - Part 1 on Food Crafters
Steakhouse Cheeseburger: Photo from Steakhouse Cheeseburger on HelloFresh

Lamb: Photo by Megan Johnston on Unsplash
Greek Roast Lamb: Photo from Slow Roast Lamb Shoulder on Feed Your Sole
Herbed Rack of Lamb: Photo from Roasted Rack of Lamb with Basil Goat Cheese Sauce on Half Baked Harvest
Lancashire Hot Pot: Photo from Traditional Lancashire Hotpot from Kitchen Sanctuary
Middle Eastern Lamb and Lentil Stew: Photo from Middle Eastern Lamb and Lentil Stew on HelloFresh
Moroccan Lamb Tajine: Photo from Lamb Tagine with Dates and Apricots on Silk Road Recipes
Pan-Fried Lamb Chops with Rosemary & Garlic: Photo from Easy Pan Seared Lamb Chops with Rich Mustard on Low Carb Maven
Red Wine Braised Lamb Shanks A: Photo by Jeff Siepman on Unsplash
Red Wine Braised Lamb Shanks B: Photo from Braised Lamb Shanks on Cafe Delites
Shepherd’s Pie: Photo from Shepherd's Pie on Once Upon a Chef
Warm Shredded Lamb with Mint & Pomegranate: Photo from Warm Shredded Lamb with Mint and Pomegranate on Rice & Kai

Pork: Photo by Annie Spratt on Unsplash
Banh-Mi (Vietnamese Sub A: Photo from Classic Vietnamese Dipping Sauce on Drive Me Hungry
Banh-Mi (Vietnamese Sub) B: Photo from Tofu Vietnamese Sub on Pick Up Limes
Dijon Herb Crusted Pork Tenderloin: Photo from Roasted Pork Tenderloin with Apples and Mustard Sauce on My Dayly Kitcken
Modenese Pork Tenderloin A: Photo by Tijiana Drndarski on Unsplash
Modenese Pork Tenderloin B: Photo by Fulvio Ciccolo on Unsplash
Pork Tenderloin with Lemon Peppercorn Sauce: Photo by Calum Lewis on Unsplash
Pork Tenderloin with Sweet Mushroom Sauce: Photo from Smothered Pork Chops in an Amazing Mushroom Gravy on The Recipe Critic
Schnitzel: Photo from Cheater's Chicken Schnitzel on Food52
Slow Cooker Parmesan Honey Pork Roast: Photo from Slow Cooker Parmesan Honey Pork Roast on Your Home Based Mom/Leigh Anne Wilkes
Tourtiere: Photo from Tourtiere on Catherine Cuisine

Poultry: Photo by Leonardo Iheme on Unsplash
Basted & Barbecued Chicken Thighs (A): Photo from Lemon-Rosemary Chicken Thighs on eMeals
Basted & Barbecued Chicken Thighs (B): Photo from Cilantro Lime Chicken Thighs  on TruLocal
Breaded Chicken Strips: Photo by Alex Haney on Unsplash
Chicken in a Creamy Mustard Mushroom Sauce: Photo and recipe from One Pan Creamy Dijon Mustard Mushroom Chicken on I Am A Food Blog
Chicken Marsala: Photo from Chicken Marsala on Cooking Classy
Chicken Quesadillas: Photo from BBQ Chicken Quesadilla on The Endless Meal
Chow Mein: Photo from One-Pot Chicken Chow Mein from Tastemade
Chris’ Super Simple Enchiladas: Photo from Chicken Enchiladas on Gimme Some Oven
Crispy Buffalo Chicken Wings: Photo from Bone In vs. Boneless Wings Which is Better on Couch Guy Sports
Crispy Chicken Parmigiana: Photo from Crispy Chicken Parmigiana on HelloFresh
Cumin Chicken and Grilled Carrots: Photo from Cumin Chicken and Grilled Carrots on HelloFresh
Easy & Juicy Roast Chicken: Photo by Alison Marras on Unsplash
Greek Chicken Livers: Photo from Spicy Chicken Liver Fry on My Heart Beets
Grilled Chicken Caprese Orzo Salad: Photo from Caprese Pasta Salad with Creamy Balsamic Dressing on Bowl of Delicious
Herby Italian Chicken with Pesto Pasta Salad: Photo from Herby Italian Chicken with Pesto Pasta Salad on Hello Fresh
One-Pan Cheesy Chicken, Broccoli, and Rice: Photo from One Pot Cheesey Chicken Broccoli Rice Casserole on Little Spice Jar
One-Pot Black Bean & Chicken Chili: Photo from One Pot Black Bean and Chicken Chili from Little Spice Jar
Pesto Chicken Tortellini with Veggies: Photo and recipe from Pesto Chicken Tortellini and Veggies on Julia's Album
Roast Chicken Holiday Dinner: Photo from The Thanksgiving Dinner Guide on The Fox & She
Romanian Chicken In A Tomato & Pea Sauce: Photo from Shutterstock
Spinach and Cheese Stuffed Chicken: Photo from Spinach and Cheese Stuffed Chicken on HelloFresh

Seafood: Photo by Nick Karvounis on Unsplash
Lemon Rosemary Broiled Salmon: Photo from Baked Salmon in Foil from Well Plated
Maple & Soy Glazed Salmon: Photo from Easy One Pan Maple Glazed Salmon on The Busy Baker
Middle Eastern-Spiced Salmon Freekeh Bowl: Photo from Middle Eastern Spiced Salmon Freekeh Bowl on HelloFresh
Pesto Baked Salmon: Photo from Pesto Baked Salmon on HelloFresh
Sesame Seared Tuna: Photo from Sesame Spiced Tuna on Paleo Leap
Simple Garlic & Lemon Shrimp: Photo from Garlic Butter Shrimp Scampi on Damn Delicious

Pasta: Photo by Sebastian Holgado on Unsplash
Angel Hair Pasta with Lemon & Pine Nuts: Photo and recipe from Lemon and Walnut Angel Hair Pasta on Nutritious Eats
Beef Stroganoff: Photo from Beef Stroganoff on Cooking Classy
Creamy Alfredo Style Shrimp Pasta: Photo from Creamy Alfredo Style Shrimp Linguine on HelloFresh
Five Cheese Pasta: Photo from One Pot Three Cheese Mac and Cheese on The Garlic Diaries
Gnocchi Bolognese: Photo from Gnocchi Bolognese on Unsplash
Jacyi’s Mac & Cheese: Photo from Baked Mac and Cheese Recipe Two Ways on The Cookie Rookie
Nora’s Super Simple Pork Ragu: Photo from Ragu, a Meat Sauce Done Right on The New York Times
Puttanesca: Photo from Puttanesca Sauce on The Kitchenista Diaries
Spicy Italian Sausage Pasta: Photo from Spicy Italian Sausage Penne Pasta on Lord Byron's Kitchen
Vegetarian Mushroom Stroganoff: Photo from Mushroom Stroganoff on Gimme Some Oven

Pizza:  Photo by Lasse Bergqvist on Unsplash
Arugula & Prosciutto Pizza: Photo from Weeknight Dinner Recipe: Prosciutto and Arugula Pizza on The Kitchn

Bowls: Photo from How to Make a Poke Bowl on Eat First
Beef Luau Bowl with Kiwi Salsa: Photo from Beef Luau Bowl with Kiwi Salsa on HelloFresh
Beef Stir-Fry: Photo and recipe from Easy Classic Chinese Beef Stir Fry on Recipe Tin Eats
Red Lentil & Sweet Potato Curry Bowl: Photo from Red Lentil and Sweet Potato Curry Bowl on Unsplash
Summer Tomato Bruschetta Bowl: Photo from Summer Tomato Bruschetta Bowl on Unsplash
Vietnamese Pork with Rice Vermicelli: Photo from Vietnamese Noodles with Lemongrass Chicken on Recipe Tin Eats
Homestyle Chicken Stew: Photo from Homestyle Chicken Stew on HelloFresh

Soup: Photo by Irina on Unsplash
Beef & Barley Soup: Photo from Instant Pot Beef Barley Soup on Eating Instantly
Classic Corn Chowder: Photo from Creamy Corn Chowder with Bacon on The Comfort of Cooking
Creamy Mushroom Soup: Photo from Cream of Mushroom Soup on Delish
Homestyle Chicken Stew: Photo from Homestyle Chicken Stew on HelloFresh
Irish Stew: Photo from Irish Stew on Jamie Oliver
Italian Sausage Soup: Photo from Italian Sausage and Bean Soup on The View from Great Island
Miso-Tahini Squash Soup: Photo from Miso-Tahini Squash Soup with Brown Rice on Epicurious
Mulligatawny Soup: Photo from Chicken Mulligatawny Soup on Simply Recipes
One-Pot Tomato Basil Tortellini Soup: Photo and recipe from One-Pot Tomato and Basil Tortellini Soup on Gal on a Mission
Potato & Leek Soup: Photo from Potato Leek Soup on Once Upon a Chef
Potato, Broccoli, & Cheddar Soup: Photo from Easy Broccoli Cheese Soup on Cafe Delites
Quick Irish Stew with Herb Garlic Crostini: Photo from Quick Irish Stew with Herb Garlic Crostini on Unsplash
Tortilla Soup: Photo from Instant Pot Chicken Tortilla Soup Recipe on Salt & Lavender
Turkey Broth: Photo from Homemade Turkey Stock on Delish

Potatoes: Photo by Eric Prouzet on Unsplash
Crash Hot Potatoes: Photo from Crash Hot Potatoes on The Pioneer Woman
Potato Rosti: Photo from Potato Rosti on Australia's Best Recipes 

Vegetables: Photo from Gabriel Gurrola on Unsplash
Asparagus with Lemon: Photo & recipe from Simple Lemon Garlic Roasted Asparagus on Nyssa's Kitchen
Green Bean Almondine: Photo from Green Beans Almondine on The Modern Proper
Green Beans with Sun-dried Tomatoes & Almonds: Photo from Blistered Green Beans with Tomato-Almond Pesto on Bon Appetit
Sweet Glazed Carrots: Photo from Easy Glazed Carrots on Foodie Crush

Sauces & Mixes: Photo by Ashim D'Silva on Unsplash
Cheddar Beer Fondue: Photo from Beer and Cheese Fondue on Crush Mag Online
Easy Caramel Dipping Sauce: Photo by Brent Hofacker from Shutterstock
Sweet & Spicy Edamame Sauce: Photo from Spicy Edamame on Peas and Crayons

Cookies: Photo by Clem Onojeghuo from Unsplash
Bridget’s Chocolate Chip Cookies: Photo from Neiman Marcus Chocolate Chip Cookies on Cooking Classy
Christmas Dog Biscuits: Photo from Homemade Pumpkin Dog Treats on Fresh April Flours
Coconut Macaroons A: Photo by Shibi Zidhick on Unsplash
Coconut Macaroons B: Photo from How to Make the Best Coconut Macaroons on The Kitchn
Jackie’s Whipped Shortbread: Photo from Whipped Shortbread Cookies on My Incredible Recipes
Nana Sheila’s Christmas Cookies: Photo from Cookie Decorating Kits for Kids from Glorious Treats
Ultra Soft Chocolate Chip Cookies: Photo from Best Pumpkin Chocolate Chip Cookie Recipe on Delish

Dessert: Photo from Pxhere
Ambrosia Salad: Photo from Ambrosia Salad on Taste of Home
Best Brownies: Photo from Fudgy Brownie Recipe on Natashas Kitchen
Blackberry Clafoutis: Photo from Berry Clafoutis on Cooking NY Times
Bread Pudding with Bourbon Sauce: Photo from Instant Pot Bread Pudding with Bourbon Sauce on The Spruce Eats
Brunch Coffee Cake: Photo from Easy One-Bowl Coffee Cake Recipe on Serious Eats
Carrot Cake: Photo by Karolina Kołodziejczak on Unsplash
Lemon Squares: Photo from Classic Lemon Bars on Simply Recipes
Pastéis de Nata: Photo by Beto Chagas on Shutterstock
Revani (Greek Semolina Cake): Photo from Greek Semolina Cake with Orange Syrup on The Spruce Eats

Muffins, Bread, & Loaves: Photo by Theme Photos on Unsplash
Banana Bread: Photo from Banana and Walnut Bread on Odlums
Bran Muffins: Photo from Raisin Bran Muffins on The Spruce Eats
Land of Nod Cinnamon Buns: Photo from Land of Nod Cinnamon Buns
Lemon Yogurt Loaf: Photo from Lemon Greek Yogurt Pound Cake on The Baker Chick
